#####################
#O     X            #
# O    X     X   O  #
#P        # #       #
#          #     #  #
#####################
